11111111114111111111+
11111111114111111111+
11111111114111111111+
55555555556555555555+
22222222224222222222+
22222222224222222222+
55555555556555555555+
33333333334333333333+
55555555556555555555+
22222222224222222222+
22222222224222222222+
55555555556555555555+
55555555556555555555+
11111111114111111111+
55555555556555555555
